    1, 20 ,90,
     3,  3,  3,  3,  3,  3,  3,  3,  3,  3,  3,  3,  3,  3,  3,  3,  3,  3,  3,  3,
     45, 45, 45, 45, 45, 45, 45, 45, 45, 45, 45, 45, 45, 45, 45, 45, 45, 45, 45, 0,
     2,  2,  2,  2,  2,  2,  2,  2,  2,  2,  2,  2,  2,  2,  2,  2,  2,  2,  2,  2,
     2,  2,  2,  2,  2,  2,  2,  2,  2,  2,  2,  2,  2,  2,  2,  2,  2,  2,  2,  2,
     2,  2,  2,  2,  2,  2,  2,  2,  2,  2, 41, 57, 57, 57, 57, 40, 2,  2,  2,  2,
     2,  2,  2,  2,  2,  2,  2,  2,  2,  2, 57, 57, 57, 57, 57, 57,  2,  2,  2,  2,
     2,  2,  2,  2,  2,  2,  2,  2,  2, 45, 57, 57, 57, 57, 57, 57,  2,  2,  2,  2,
     2,  2, 56, 56, 56,  2,  2,  2,  2, 45, 42, 57, 57, 57, 57, 43,  2,  2,  2,  2,
     2,  2,  2,  2,  2,  2,  2,  2,  2,  2, 45, 45, 57, 57,  2,  2,  2,  2,  2,  2,
     2,  2,  2, 56,  2,  2,  2,  2,  2,  2,  2,  2, 57, 57,  2,  2,  2,  2,  2,  2,
     2,  2, 56, 56, 56, 56,  2,  2,  2,  2,  2,  2, 57, 57,  2,  2,  2,  2,  2,  2,
     2,  2,  2,  2,  2,  2,  2,  2,  2,  2,  2,  2, 57, 57,  2,  2,  2,  2,  2,  2,
     2,  2,  2,  2,  2,  2,  2,  2,  2,  2,  2,  2, 57, 43,  2,  2,  2,  2,  2,  2,
     2,  2,  2,  2,  2,  2,  2,  2,  2,  2,  2, 41, 57,  2,  2,  2,  2,  2,  2,  2,
    
     2,  2,  2,  2,  2,  2,  2,  2,  2,  2, 41, 57, 43,  2,  2,  2,  2,  2,  2,  2,
     2,  2,  2,  2,  2,  2,  2,  2,  2, 41, 57, 43,  2,  2,  2,  2,  2,  2,  2,  2,
     2,  2,  2,  2,  2,  2,  2,  2, 54, 57, 57,  2,  2,  2,  2,  2,  2,  2,  2,  2,
     2,  2,  2,  2,  2,  2,  2,  2,  2, 57, 57,  2,  2,  2,  2,  2,  2,  2,  2,  2,
     2,  2,  2,  2,  2, 54,  2, 54,  2, 57, 57,  2, 54, 54, 54,  2,  2,  2,  2,  2,
     2,  2,  2,  2,  2,  2,  2,  2,  2, 57, 57,  2,  2,  2,  2,  2,  2,  2,  2,  2,
     2,  2,  2,  2,  2,  2,  2,  2, 45, 57, 57, 45,  2,  2,  2,  2,  2,  2,  2,  2,
     2,  2,  2,  2,  2,  2,  2,  2, 45, 57, 57, 45,  2,  2,  2,  2,  2,  2,  2,  2,
     2,  2,  2,  2,  2,  2, 41, 57, 57, 57, 57, 45,  2,  2, 01, 01, 01, 01, 01,  2,
     2,  2,  2, 54, 54, 54, 57, 57, 57, 57, 57, 40, 45, 33, 01, 01, 01, 01, 01, 01,
     2,  2,  2, 54, 54, 54, 57, 57, 57, 57, 57, 57, 45, 01, 01, 01, 01, 01, 01, 01,
     2,  2,  2,  2, 54, 54, 42, 57, 57, 57, 57, 43, 54, 01, 01, 01, 01, 01, 01, 01,
     2,  2,  2,  2,  2, 54, 54, 57, 57, 57, 57, 45,  2, 34, 01, 01, 35,  2,  2,  2,
     2,  2,  2,  2,  2,  2,  2,  2,  2,  2,  2,  2,  2, 54, 01, 35,  2,  2,  2,  2,
     2,  2,  2,  2,  2,  2,  2,  2,  2,  2,  2,  2,  2,  2,  2,  2,  2,  2,  2,  2,
    
     2,  2,  2,  2,  2,  2,  2,  2,  2,  2,  2,  2,  2,  2,  2,  2,  2,  2,  2,  2,
     2,  2,  2,  2,  2,  2,  2,  2,  2,  2,  2,  2,  2,  2,  2,  2,  2,  2,  2,  2,
     2,  2,  2,  2,  2,  2,  2,  2,  2,  2,  2,  2,  2,  2,  2,  2,  2,  2,  2,  2,
     2,  2,  2,  2,  2,  2,  2,  2,  2,  2,  2,  2,  2,  2,  2,  2,  2,  2,  2,  2,
     2,  2,  2,  2, 45, 45, 45,  2,  2,  2,  2,  2,  2,  2,  2,  2,  2,  2,  2,  2,
     2,  2,  2,  2,  2,  2,  2,  2,  2,  2,  2,  2,  2, 33,  1, 32,  2,  2,  2,  2,
     2,  2,  2,  2,  2,  2,  2,  2,  2,  2,  2,  2,  2,  1,  1,  1,  2,  2,  2,  2,
     2,  2,  2,  2,  2,  2,  2,  2,  2,  2,  2,  2,  2,  1,  1,  1,  2,  2,  2,  2,
     2,  2,  2,  2,  2,  2,  2,  2,  2,  2,  2,  2,  2, 34,  1, 35,  2,  2,  2,  2,
     2,  2,  2, 45,  2,  2,  2,  2,  2,  2,  2,  2,  2,  2,  2,  2,  2,  2,  2,  2,
     2,  2,  2, 45,  2,  2,  2,  2,  2,  2,  2,  2,  2,  2,  2,  2,  2,  2,  2,  2,
     2,  2,  2, 45,  2,  2,  2,  2,  2,  2,  2,  2,  2,  2,  2,  2,  2,  2,  2,  2,
     2,  2,  2, 45,  2,  2,  2,  2,  2,  2,  2,  2,  2,  2,  2,  2,  2,  2,  2,  2,
     2,  2,  2,  2,  2,  2,  2,  2,  2,  2,  2,  2,  2,  2,  2,  2,  2,  2,  2,  2,
     2,  2,  2,  2,  2,  2,  2,  2,  2,  2,  2,  2,  2,  2,  2,  2,  2,  2,  2,  2,
    
     2,  2,  2,  2,  2,  2,  2,  2,  2,  2,  2,  2,  2,  2,  2,  2,  2,  2,  2,  2,
     2,  2,  2,  2,  2,  2,  2,  2,  2,  2,  2,  2,  2,  2,  2,  2,  2,  2,  2,  2,
     2,  2,  2,  2,  2,  2,  2,  2,  2,  2,  2,  2,  2,  2,  2,  2,  2,  2,  2,  2,
     2,  2,  2,  2,  2,  2,  2,  2,  2,  2,  2,  2,  2,  2,  2,  2,  2,  2,  2,  2,
     2,  2,  2,  2,  2,  2,  2,  2,  2,  2,  2,  2,  2,  2,  2,  2,  2,  2,  2,  2,
     2,  2,  2,  2, 56, 56, 56, 56,  2,  2,  2,  2,  2,  2,  2,  2,  2,  2,  2,  2,
     2,  2,  2,  2,  2,  2,  2,  2, 56, 56, 56, 56,  2,  2,  2,  2,  2,  2,  2,  2,
     2,  2,  2,  2,  2,  2,  2,  2,  2,  2,  2,  2,  2,  2,  2,  2, 45,  2,  2,  2,
     2,  2,  2,  2,  2,  2,  2,  2,  2,  2,  2,  2,  2,  2,  2,  2, 45,  2,  2,  2,
     2,  2,  2,  2,  2,  2,  2,  2,  2,  2,  2,  2,  2,  2, 45,  2, 45,  2,  2,  2,
     2,  2,  2,  2,  2,  2,  2,  2,  2,  2,  2,  2,  2,  2, 45, 45, 45,  2,  2,  2,
     2,  2,  2,  2, 56, 56,  2,  2,  2,  2,  2,  2,  2,  2,  2, 45,  2,  2,  2,  2,
     2,  2,  2,  2,  2, 56, 56,  2,  2,  2,  2,  2,  2,  2,  2,  2,  2,  2,  2,  2,
     2,  2,  2,  2,  2, 56, 56,  2,  2,  2,  2,  2,  2,  2,  2,  2,  2,  2,  2,  2,
     2,  2,  2,  2,  2,  2,  2,  2,  2,  2,  2,  2,  2,  2,  2,  2,  2,  2,  2,  2,

     2,  2,  2,  2,  2,  2,  2,  2,  2,  2,  2,  2,  2,  2,  2,  2,  2,  2,  2,  2,
     2,  2,  2,  2,  2,  2,  2,  2,  2,  2,  2,  2,  2,  2,  2,  2,  2,  2,  2,  2,
     2,  2,  2,  2,  2,  2,  2,  2,  2,  2,  2,  2,  2,  2,  2,  2,  2,  2,  2,  2,
     2,  2,  2,  2,  2,  2,  2,  2,  2,  2,  2,  2,  2,  2,  2,  2,  2,  2,  2,  2,
     2,  2,  2,  2,  2,  2,  2,  2,  2,  2,  2,  2,  2,  2,  2,  2,  2,  2,  2,  2,
     2,  2,  2, 45, 45, 45,  2,  2,  2,  2,  2,  2,  2,  2,  2,  2,  2,  2,  2,  2,
     2,  2,  2,  2,  2,  2,  2,  2,  2,  2,  2,  2,  2, 56, 56, 56,  2,  2,  2,  2,
     2,  2,  2,  2, 45,  2,  2,  2,  2,  2,  2,  2,  2,  2, 56, 56,  2,  2,  2,  2,
     2,  2,  2,  2,  2, 45,  2,  2,  2,  2,  2,  2,  2,  2, 56, 56,  2,  2,  2,  2,
     2,  2,  2,  2,  2,  2,  2,  2,  2,  2,  2,  2,  2,  2,  2,  2,  2,  2,  2,  2,
     2,  2,  2,  2,  2,  2,  2,  2,  2,  2,  2,  2,  2,  2,  2,  2,  2,  2,  2,  2,
     2,  2,  2,  2,  2,  2,  2,  2,  2,  2,  2,  2,  2,  2,  2,  2,  2,  2,  2,  2,
     2,  2,  2,  2,  2,  2,  2,  2,  2,  2,  2,  2,  2,  2,  2,  2,  2,  2,  2,  2,
     2,  2,  2,  2,  2,  2,  2,  2,  2,  2,  2,  2,  2,  2,  2,  2,  2,  2,  2,  2,
     2,  2,  2,  2,  2,  2,  2,  2,  2,  2,  2,  2,  2,  2,  2,  2,  2,  2,  2,  2,

     2,  2,  2,  2,  2,  2,  2,  2,  2,  2,  2,  2,  2,  2,  2,  2,  2,  2,  2,  2,
     2, 46,  2,  2,  2,  2,  2,  2,  2,  2,  2,  2,  2,  2,  2,  2,  2, 46,  2,  2,
     2,  2,  2,  2,  2,  2,  2,  2,  2,  2,  2,  2,  2,  2,  2,  2,  2,  2,  2,  2,
     2,  2,  2,  2, 33,  1, 32,  2,  2,  2,  2,  2,  2,  2,  2,  2,  2,  2,  2,  2,
     2,  2,  2,  2,  1,  1,  1,  2,  2,  2,  2,  2,  2,  2,  2,  2,  2,  2,  2,  2,
     2,  2,  2,  2, 34,  1, 35,  2,  2,  2,  2,  2,  2,  2,  2,  2,  2,  2,  2,  2,
     2,  2,  2,  2,  2,  2,  2,  2,  2,  2,  2,  2,  2,  2,  2,  2,  2,  2,  2,  2,
     2, 46,  2,  2,  2,  2,  2,  2,  2,  2,  2,  2,  2,  2, 56,  2,  2,  2,  2,  2,
     2,  2,  2,  2,  2,  2,  2,  2,  2,  2,  2,  2,  2,  2,  2,  2,  2,  2,  2,  2,
     2,  2,  2,  2,  2,  2,  2,  2,  2,  2,  2,  2,  2,  2,  2,  2,  2,  2,  2,  2,
     2,  2,  2,  2,  2, 56,  2,  2,  2,  2,  2,  2, 56,  2,  2,  2,  2,  2,  2,  2,
     2,  2,  2,  2,  2,  2,  2,  2,  2,  2,  2,  2,  2,  2,  2,  2,  2,  2,  2,  2,
     2,  2,  2,  2,  2,  2,  2,  2,  2,  2,  2,  2,  2,  2,  2,  2,  2,  2,  2,  2,
     2,  2,  2,  2,  2,  2,  2,  2,  2,  2,  2,  2,  2,  2,  2,  2,  2,  2,  2,  2,
    3,  2,  2,  2,  2, 3, 3, 3,  2,  2,  2,  2, 3, 3, 3,  2,  2,  2, 3, 3